  0/  0/  0/  0/t12/c10/c10/c10/c10/c10/c10/c10/c10/c10/c10/t11/  0/  0/
  0/  0/  0/  0/c11/  0/  0/  0/  0/  0/  0/  0/  0/  0/  0/c13/  0/  0/
  0/  0/  0/  0/c11/  0/  0/  0/  0/  0/  0/  0/  0/  0/  0/c13/  0/  0/
  0/  0/  0/  0/c11/  0/  0/  0/  0/  0/k13/  0/  0/  0/  0/c13/  0/  0/
  0/  0/  0/  0/c11/  0/  0/  0/  0/  0/  0/  0/  0/  0/  0/c13/  0/  0/
c10/c10/c10/c10/c11/  0/  0/  0/  0/  0/  0/  0/  0/  0/  0/c13/  0/  0/
  0/  0/  0/  0/c11/  0/  0/  0/  0/  0/  0/  0/  0/  0/  0/c13/  0/  0/
  0/  0/  0/  0/c11/  0/  0/  0/  0/  0/  0/  0/  0/  0/  0/c13/  0/  0/
  0/  0/  0/  0/c11/  0/  0/  0/  0/  0/  0/  0/  0/  0/  0/c13/  0/  0/
  0/  0/  0/  0/t13/c12/c12/c12/c12/c12/c12/c12/c12/c12/c12/t10/  0/  0/
  0/  0/  0/  0/  0/  0/  0/  0/  0/  0/  0/  0/  0/  0/  0/  0/  0/  0/
