  0/  0/  0/  0/  0/  0/  0/  0/  0/  0/  0/  0/  0/  0/  0/  0/  0/  0/
  0/  0/  0/  0/  0/  0/  0/  0/  0/  0/  0/  0/  0/  0/  0/  0/  0/  0/
  0/  0/  0/  0/  0/  0/  0/  0/  0/  0/  0/  0/  0/  0/  0/  0/  0/  0/
  0/  0/  0/  0/  0/  0/  0/  0/  0/  0/  0/  0/  0/  0/  0/  0/  0/  0/
  0/  0/  0/t22/t21/  0/  0/  0/  0/  0/  0/  0/  0/  0/  0/  0/  0/  0/
c10/c10/c10/x10/t20/  0/  0/  0/  0/  0/  0/  0/  0/  0/  0/  0/  0/  0/
  0/  0/  0/t23/t20/  0/  0/  0/  0/  0/  0/  0/  0/  0/  0/  0/  0/  0/
  0/  0/  0/  0/  0/  0/  0/  0/  0/  0/  0/  0/  0/  0/  0/  0/  0/  0/
  0/  0/  0/  0/  0/  0/  0/  0/  0/  0/  0/  0/  0/  0/  0/  0/  0/  0/
  0/  0/  0/  0/  0/  0/  0/  0/  0/  0/  0/  0/  0/  0/  0/  0/  0/  0/
  0/  0/  0/  0/  0/  0/  0/  0/  0/  0/  0/  0/  0/  0/  0/  0/  0/  0/
